.......................................................................................................................................................................................................................................
....................................................................................................................................................................................................................................X..
.............................................................................................................................................................................................................................##########
....................................................................................................................................................................................................................E....##............
..........................................................................................................................................................................................................###..########................
.......................................................................................................................................................................................................................................
.......................................................................................................................................................................................................##..............................
...........................................................................................................E...........................................................................................................................
....................................................................................................#########...............................................................................E....######................................
................................................................................................#####...................E......######.................................................#########........................................
.....................................................................................E.....#####...............###...#######........................................................##.................................................
..........E.............##...........##..###.....................................##########............................................###..........................................##.................................................
.....########......###............##........................##.....##..........##.................................................................................................##...................................................
.1..........#..................E...............E...............E...........E.##......................................................................E............................##...................................................
##############..#########################...#####..####..#########...###########..........................................................###############..#..#..#..#..#..##########...................................................