............................
............................
............................
............................
............................
............................
....#.......................
...##.......................
.1...X......................
############################