..................................................................................................
..................................................................................................
..................................................................................................
..................................................................................................
.....L............................................................................................
.....#............................................................................................
....##............................................................................................
...###........##..................................................................................
.1...................R..........................................................................X.
#############....#################################################################################