............................
............................
............................
............................
............................
.....#......................
....##......................
...###......................
.1....X.....................
############################