..............................................................................................................#
..............................................................................................................#
..............................................................................................................#
..............................................................................................................#
................................................................................................#####.........#
.....................................................................................E.....#####.....E........#
...........E............TT...........##..###.....................................#TTT######.......######T######
.....######TT......###............##...........................................##.............................#
.1..........#..................E.....................E.......................##.X.............................#
##############..############TTTT#######TT...#####..#T##..########T...##########################################